CCCCCCCCCWCCCCCCCCCW
WWWCCCWWCWCCCCCCCCCW
WCCCCCCWCWCWCCCCCCCW
WCWWWWCWCWCCCCWCCCCW
WCWCCCCWCWCCCCCCCCCW
WCWCCCCWCWCCCCCCCCCC
WCWCCCCCCWCCCCCTWWCC
WCWWWWWWCCWWWWCCWCWC
WCCCCCCWCCCCCCWWWCCC
WWWWWWCCCCCCCCCCCCCW