CCCCWWCCCT
CCCCWWCCCC
CCCCWWCCCC
CCCCWWCCCC
CCCCCCCCCC
CCCCCCCCCC
CCCCWWCCCC
CCCCWWCCCC
CCCCWWCCCC
CCCCWWCCCC