CCCWCCCCCC
CWCCCCCWWC
CCCWCCCCCC
CCCCCCCCCC
WCCCWWCCCW
WCCCCCCCCW
CWWCCCCCCC
CCCCCWCCWC
CCCCCWCCCW
CCWCCWCTWW