DDDDDDDDDW
WWWWWWWWDW
WDDDDDDWDW
WDWWWWDWDW
WDWDDWDWDW
WDWDWWDWDW
WDWDDDDWDW
WDWWWWWWDW
WDDDDDDDDW
WWWWWWWWWW